?????????????????????????????????????????????????????????????
?S        ?   ?     ?         ?     ?       ?     ?       ? ?
? ??????? ? ? ? ? ??? ????? ? ????? ? ??? ? ??? ? ??? ? ? ? ?
? ?     ? ? ? ? ?       ?   ?     ?     ? ?     ?   ? ? ? ? ?
????? ??? ? ? ??? ??????? ??????? ? ????? ????????? ??? ? ? ?
?     ?   ? ?   ?   ?   ?   ?     ? ?     ?       ?   ? ?   ?
? ??? ? ??? ??? ????? ? ??? ? ????? ? ????? ? ??????? ? ?????
? ?   ?   ? ? ?   ?   ?     ? ?     ?   ?   ?   ?   ? ?     ?
? ??????? ? ? ??? ? ????????? ????????? ??? ??? ? ? ? ? ??? ?
?       ? ? ?     ?         ?     ?   ?   ?   ?   ?   ?   ? ?
? ??? ??? ? ? ????? ??????? ????? ? ? ??? ??? ????????????? ?
? ? ?   ? ? ?   ?         ?   ? ?   ? ?   ? ? ?             ?
? ? ??? ? ? ??? ????????????? ? ????? ? ??? ? ? ????? ????? ?
? ?   ? ?   ?   ?       ?     ?   ? ?   ?     ? ?   ?   ?   ?
? ??? ? ????? ??? ????? ? ????? ? ? ????? ??????? ? ??? ? ???
? ?   ?     ? ?   ?     ?   ?   ? ? ?     ?       ? ?   ?   ?
? ? ? ??? ??? ? ??? ??????? ? ? ? ? ? ????????? ??? ? ????? ?
?   ?   ?   ? ? ? ?     ?   ? ? ?   ?       ?   ?   ?   ? ? ?
??????? ??? ? ? ? ????? ? ??? ? ??????????? ? ??? ????? ? ? ?
?         ?     ?         ?   ?               ?         ?  G?
?????????????????????????????????????????????????????????????
